{
  "width": 30,
  "height": 40,
  "map": [
    [  1,  2,  2,  3,  0,  0,  0,  0,  0,  0,  0,  0,  0,  0,  0,  8,  8,  8,  8,  8,  0,  0,  0,  0,  0,  0,  0,  0,  0,  0,  0],
    [  9, 10, 10,  7,  2,  3,  0,  0,  0,  0,  0,  0,  0,  0,  0,  0,  0,  0,  0,  0,  0,  0,  0,  0,  0,  0,  0,  0,  0,  0,  0],
    [  9, 10, 10, 10, 10, 11,  0,  0,  0,  0,  0,  0,  0,  0,  0,  0,  0,  0,  0,  0,  0,  0,  0,  0,  0,  0,  0,  0,  0,  0,  0],
    [  9, 10, 10, 15, 18, 19,  0,  0,  0,  0,  0,  0,  0,  0,  0,  0,  0,  0,  0,  0,  0,  0,  0,  0,  0,  0,  0,  0,  0,  0,  0],
    [ 17, 18, 18, 19,  0,  0,  0,  0,  0,  0,  0,  0,  0,  0,  0,  0,  0,  0,  0,  0,  0,  0,  0,  0,  0,  0,  0,  0,  0,  0,  0],
    [  0,  0,  0,  0,  0, 83,341,342,343, 83,  0,  0,  0, 83, 83, 83, 83, 83, 83, 83, 83, 83,207, 83, 83, 83, 83, 83, 83, 83, 83],
    [ 82, 83, 83, 83, 68, 50,349,350,351, 50, 76,207, 68,551,543, 61, 50, 50, 59, 50, 50, 50,215, 59, 50, 50, 50, 59, 50, 50, 50],
    [ 50, 59, 51, 50, 50, 51,357,358,359, 50,567,215,551,551,543, 51, 50, 59, 50, 50, 50, 50,215, 59, 50, 50, 50, 59, 50, 50, 50],
    [ 50, 50, 50, 61, 50, 50,365,366,367, 50,575,215,551,551,559, 49, 49, 49, 49, 49, 49, 49,223, 49, 49, 49, 49, 49, 49, 49, 49],
    [ 49, 49, 49, 49, 49, 49,373,374,375, 49,583,215,559, 49,  0,  0,  0,  0,  0,  0,  0,  0,  0,  0,  0,  0,  0,  0,  0,  0,  0],
    [  0,  0,  0,  0,  0,  0,  0,  0,  0,  0,  0,223,  0,  0,  0,  0,  0,  0,  0,  0,  0,  0,  0,  0,  0,  0,  0,  0,  0,  0,  0],
    [  0,  0,  0,  0,  0,  0,  0,  0,  0,  0,  0,  0,  0,  0,  0,  0,  0,  0,  0,  0,  0,  0,  0,  0,  0,  0,  0,  0,  0,  0,  0],
    [  0,  0,  0,  0,  0,  0,  0,  0,  0,  0,  0,  0,  0,  0,  0,  0,  0,  0,  0,  0,  0,  0,  0,  0,  0,  0,  0,  0,  0,  0,  0],
    [  0,  0,  0,  0,  0,  0,  0,  0,  0,  0,  0,  0,  0,  0,  0,  0,  0,  0,  0,  0,  0,  0,  0,  0,  0,  0,  0,  0,  0,  0,  0],
    [  1,  2,  2,  3,  0,  0,  0,  0,  0,  0,  0,  0,  0,  0,  0,  8,  8,  8,  8,  8,  0,  0,  0,  0,  0,  0,  0,  0,  0,  0,  0],
    [  9, 10, 10,  7,  2,  3,  0,  0,  0,  0,  0,  0,  0,  0,  0,  0,  0,  0,  0,  0,  0,  0,  0,  0,  0,  0,  0,  0,  0,  0,  0],
    [  9, 10, 10, 10, 10, 11,  0,  0,  0,  0,  0,  0,  0,  0,  0,  0,  0,  0,  0,  0,  0,  0,  0,  0,  0,  0,  0,  0,  0,  0,  0],
    [  9, 10, 10, 15, 18, 19,  0,  0,  0,  0,  0,  0,  0,  0,  0,  0,  0,  0,  0,  0,  0,  0,  0,  0,  0,  0,  0,  0,  0,  0,  0],
    [ 17, 18, 18, 19,  0,  0,  0,  0,  0,  0,  0,  0,  0,  0,  0,  0,  0,  0,  0,  0,  0,  0,  0,  0,  0,  0,  0,  0,  0,  0,  0],
    [  0,  0,  0,  0,  0,  0,  0,  0,  0,  0,  0,  0,  0,  0,  0,  0,  0,  0,  0,  0,  0,  0,  0,  0,  0,  0,  0,  0,  0,  0,  0],
    [  0,  0,  0,  0,  0,  0,  0,  0,  0,  0,  0,  0,  0,  0,  0,  0,  0,  0,  0,  0,  0,  0,  0,  0,  0,  0,  0,  0,  0,  0,  0],
    [  0,  0,  0,  0,  0,  0,  0,  0,  0,  0,  0,  0,  0,  0,  0,  0,  0,  0,  0,  0,  0,  0,  0,  0,  0,  0,  0,  0,  0,  0,  0],
    [  0,  0,  0,  0,  0,  0,  0,  0,  0,  0,  0,  0,  0,  0,  0,  0,  0,  0,  0,  0,  0,  0,  0,  0,  0,  0,  0,  0,  0,  0,  0],
    [  0,  0,  0,  0,  0,  0,  0,  0,  0,  0,  0,  0,  0,  0,  0,  0,  0,  0,  0,  0,  0,  0,  0,  0,  0,  0,  0,  0,  0,  0,  0],
    [  1,  2,  2,  3,  0,  0,  0,  0,  0,  0,  0,  0,  0,  0,  0,  8,  8,  8,  8,  8,  0,  0,  0,  0,  0,  0,  0,  0,  0,  0,  0],
    [  9, 10, 10,  7,  2,  3,  0,  0,  0,  0,  0,  0,  0,  0,  0,  0,  0,  0,  0,  0,  0,  0,  0,  0,  0,  0,  0,  0,  0,  0,  0],
    [  9, 10, 10, 10, 10, 11,  0,  0,  0,  0,  0,  0,  0,  0,  0,  0,  0,  0,  0,  0,  0,  0,  0,  0,  0,  0,  0,  0,  0,  0,  0],
    [  9, 10, 10, 15, 18, 19,  0,  0,  0,  0,  0,  0,  0,  0,  0,  0,  0,  0,  0,  0,  0,  0,  0,  0,  0,  0,  0,  0,  0,  0,  0],
    [ 17, 18, 18, 19,  0,  0,  0,  0,  0,  0,  0,  0,  0,  0,  0,  0,  0,  0,  0,  0,  0,  0,  0,  0,  0,  0,  0,  0,  0,  0,  0],
    [  0,  0,  0,  0,  0,  0,  0,  0,  0,  0,  0,  0,  0,  0,  0,  0,  0,  0,  0,  0,  0,  0,  0,  0,  0,  0,  0,  0,  0,  0,  0]
  ]
}
